Hello (formal)	Здрaвствуйтуе [zdrA-stvooy-tye]
Hello (informal)	Здрaвствуй [zdrA-stvooy]
Goodbye	До свидания [da svee-dA-nee-ya]
How are things with you? (formal)	Кaк у вас дела? [kak oo vas dye-lA]
Thank you, fine	Спасибо, хорошо [spa-sEE-ba, ha-ra-shO]
How are things with you? (informal)	Как у тебя дела? [kak oo teb-ya dye-lA]
How do they call you? (informal)	как тебя зовут? [kak teb-ya za-voot]
I am called	Меня зовут [men-YA za-vOOt]
How do they call you? (formal)	Как вас зовут? [kak vas za-vOOt]
Very glad (to meet you) (male speaker)	Очень рад [O-chyen rAd]
Very glad (to meet you) (female speaker)	Очень рада [O-chyen rA-da]
Pardon/Excuse me/Sorry?	Простите [prasteetye]
You (formal)	Вы [vi]
You  (informal)	ТЫ [ti]
English (male)	Англичанин [angleechaneen]
English (female)	Англичанка [angleechanka]
Yes, I am...	Да, я... [da, ya]
No, I am not...	Нет, я не... [nyet, ya nye]
Student (male / female)	Студент / Студентка [stood-YEnt / stood-YEnt-ka]
They are married (male plural or formal)	Они женаты [anee zhenaty]
Married (male informal)	Женат [zhenat]
Married (female)	Замужем [zamoozhem]
Zero	Ноль [nol]
One	Один [adeen]
Two	Два [dva]
Three	Три [tree]
Four	Четыре [chetyre]
This is Anna	Это Анна [eta anna]
This is my friend (male)	Это мои друг [eta moy droog]
This is my friend (female)	Это моя подруга [eta maya padrooga]
This is my husband	Это мои муж [eta moy moozh]
This is my wife	Это моя жена [eta maya zhena]
Do you have children?	У вас есть дети? [oo vas yest dyetee]
I have...	У меня есть... [oo men-YA yest]
Son	Сын [syn]
Daughter	Дочь [doch]
And	И [ee]
How is he/she called?	Как его/её зовут? [kak yevo/yeyo zavoot]
He / She is called...	Его / Её зовут [yevo / yeyo zavoot]
Is this...?	Это...? [eta]
Brother	Брат [brAt]
Sister	Сестра [sYE-stra]
Five	Пять [pyat]
Six	Шесть [shyest]
Seven	Семь [syem]
Eight	Восемь [vosem]
Nine	Девять [dyevat]
Ten	Десять [dyesat]
Bar	Бар [bar]
Cafe	Кафе [cafe]
Barman	Бармен [barmen]
Kiosk	Киоск [kiosk]
What would you like?	Что вам угодно? [shto vam oogodna]
Tea, please	Чаи пожалуйста [chay pazhalsta]
Coffee, please	Кофе пожалуйста [kofye pazhalsta]
Fine	Хорошо [kharasho]
Thank you	Спасибо [spaseeba]
Water	Вода [vada]
Wine	Вино [veeno]
Beer	Пиво [peeva]
Lemonade	Лимонад [leemonad]
With sugar	С сахаром [s sakharom]
Without sugar	Без сахара [byez sakhara]
Sugar	Сахар [sakhar]
With milk	С молоком [s malakom]
Without milk	Без молока [byez malaka]
What would you like? (formal)	Что вы хотите? [shto vy khateetye]
What would you like? (informal)	Что ты хочешь? [shto ty khochyesh]
Yes, please	Да, пожалуйста [da pazhalsta]
No, thank you	Нет, спасибо [nyet spaseeba]
I know	Я знаю [ya znA-yu]
Magazine	Журнал [zhoornal]
Hotel	Гостиница [gas-tEE-neetsa]
Good morning	Доброе утро [dó-braye oot-ra]
Excuse me, please	Простите, пожалуйста [prasteetye, pazhalsta]
Tell me, please	Скажите, пожалуйста [skasheetye, pazhalsta]
Go	Идите [eedEEtye]
Left	Налево [nalevo]
Forward	Прямо [pryamo]
Right	Направо [napravo]
Is it far?	Это далеко? [eta dalyeko]
Yes, it's far	Да, далеко [da, dalyeko]
No, it's not far	Нет, недалеко [nyet, nedalyeko]
Ten minutes by foot	Десять минут пешком [desyat meenoot pyeshkom]
Five minutes by bus	Пять минут автобусом [pyat meenoot avtoboosom]
One kilometer	Один километр [adeen keelometr]
Where do you live? (formal)	Где вы живёте? [gdye vy zheevyotye]
Where do you live? (informal)	Где ты живёшь? [gde ty zheevYOsh]
I live in St Petersburg	Я живу в Санкт-Петербурге [ya zheevoo vy Sant-Peterboorg]
Eleven	Одиннадцать [adeenatset]
Twelve	Двенадцать [dvanatset]
Thirteen	Тринадцать [treenatset]
Fourteen	Четырнадцать [chetyrenatset]
Fifteen	Пятнадцать [pyatnatset]
Sixteen	Шестнадцать [shyestnatset]
Seventeen	Семнадцать [syemnatset]
Eighteen	Восемнадцать [vosemnatset]
Nineteen	Девятнадцать [devyatnatset]
Twenty	Двадцать [dvatset]
Twenty-one	Двадцать один [dvatset adeen]
Delicious	Вкусно [fkoosna]
Newspaper	Газета [ga-zye-ta]
Day	День [dyen]
House	Дом [dom]
Menu	Меню [mye-nyu]
Moscow	Москва [mask-va]
Window	Окно [ak-no]
Taxi	Такси [tak-see]
Chocolate	Шоколад [sha-ka-lat]
He, it (male)	Он [on]
She, it (female)	Она [a-na]
It	Оно [a-no]
Here (it is)	Вот [vot]
Give me, please, the menu	Дайте, пожалуйста, меню [da-yte, pazhalsta, mye-nyu]
I don't understand	Я не понимаю [ya nye pan-ee-ma-yu]
Do you understand me?	Вы меня понимаете? [vy menya pan-ee-ma-etye]
Okay	Ладно [ladno]
Hi (informal)	Привет [pree-vYEt]
My (male / female)	Мой / Моя [mOy / maYA]
Your (formal) (male / female)	Ваш / Ваша [vash / vAsha]
Passport	Паспорт [pAss-port]
Visa	Виза [vEEza]
Luggage	Багаж [bag-Azh]
Ticket	Билет [bil-YEt]
Russian (male / female)	Русский / Русская [rOO-ski / rOO-skaya]
English (male / female)	Англичанин / Англичанка [an-glee-chAn-een / an-glee-chAn-ka]
American (male / female)	Американец / Американка [am-e-ree-kAn-its / am-e-ree-kAn-ka]
Muscovite (male / female)	Москвич / Москвичка [mas-kvEEch / mas-kvEEch-ka]
Tourist (male / female)	Турист / Туристка [too-rEEst / too-rEEst-ka]
Very	Очень [O-chyen]
We	Мы [mi]
They	Онй [anee]
Actor / Actress	Актёр / Актриса [ak-tYOr / ak-trEEsa]
Engineer	Инженер [en-zhyen-YEr]
Place, seat	Место [mYEst-o]
There	Там [tam]
Surname	Фамилия [fam-EE-lee-ya]
First name	Имя [EE-mya]
Patronomic	Отчество [O-tchye-stvo]
You already speak Russian well	Вы уже хорошо говорите по-русски [vi oo-zhYE ha-ra-shO go-vo-rEEt-ye po-rOO-skee]
I (am currently) learning	Я изучаю [ya ee-zooch-aYU]
Russian (language)	Русский язык [rOO-ski yaz-Ik]
(for) three years	Три года [tree gOda]
I live	Я живу [ya zhee-vOO]
In Moscow	В Москве [vi mask-vYE]
Where	Где [gdYE]
You (formal) live	В живёте [vi zhee-vYO-tye]
I work	Я работаю [ya ra-bOt-ayu]
You work (formal)	В работаете [vi ra-bat-ay-ete]
English (language)	Английский язык [ang-lEEe-skee yaz-Ik]
I teach	Я преподаю [ya prye-pad-aYU]
Here (in this place)	Здесь [zdyes]
How	Как [kak]
Very pleased (to meet you)	Очень приятно [O-chyen pree-YAtno]
Interesting	Интересно [een-ter-es-no]
Work	Работать [ra-bOt-at]
He / she / it works	Он / она / оно работает [on / an-A / an-O ra-bOt-ayet]
Your (informal) (male / female)	Твой / твоя [tvOy / tva-YA]
We work	Мы работаем [mi ra-bOt-ayem]
You work (informal)	Ты работаешь [ti ra-bOt-ayesh]
They work	Они работают [an-EE ra-bOt-ayut]
Huh?	Чево [chye-vO]
Small	Маленький [ma-lYEn-kee]
The bird chatterer is distinguished by cleverness and quick wit	Птица говорун отличается умом и сообразительностью [p-tee-tsa gO-varoon at-lee-chayetsya oo-mOm ee so-bra-zeetyel-nastyu]
That's why	Вот почему [vot poch-yem-OO]
Excuse me	Извините [ee-zvee-nEE-tye]
Sometimes	Иногда [ee-nog-dА]
Also	Тоже [tOzh-ye]
Only	Только [tOl-ka]
Big	Большой [bol-shOy]
Flat	Квартира [kvar-tEEra]
Of course	Конечно [ka-nYE-chno]
Beautiful architecture	Красивая архитектура [kra-sEE-vaya ar-khee-tyekh-tYUra]
For example	Например [napree-mYEr]
To be situated	Находится [nakhod-EEt-sya]
River	Река [ryekA]
Old	Старый [stAr-y]
Person	Человек [chye-lo-vYEk]
You don't know...?	Вы не знаете...? [vi nye zhnA-yetye]
How do I / does one get to... ?	Как пройти в...? [kak pray-tEE v]
Where to?	Куда [koodA]
Do you have... ?	У вас есть... ? [oo vas yest]
Plan / map	План [plan]
Well...	Ну [noo]
Understood	Понятно [pan-YAtna]
To see	Видеть [vEE-dyet]
Restaurant	Ресторан [rest-oran]
Over there	Вон там [vOn tAm]
To go	Идти [ееdtEE]
So...	Так... [tak]
You don't know...	Вы не знаете... [vy ne znA-ete]
Travel agency	турагенство [tyooragenstve]
White	белый (beliy)
wrinkle	морщина [morschina]
unsatisfied	неудовлетворённый [neudovletvoryonniy]
See	смотреть [smotret]
Hand	рука [ruka]
Police officer	полицейский [politseyskiy]
Rain forest	влажный тропический лес [vlazhniy tropicheskiy les]
Beaver	бобр [bobr]
Leg	нога [noga]
Angry	сердитый [serditiy]
Tornado	торнадо [tornado]
Microwave oven	микроволновая печь [mikrovalnovaya pech]
Guide	гид&amp;nbsp;[gid]
Desktop computer	настольный компьютер [nastol'nyy komp'yuter]
Book	книга&amp;nbsp;[kniga]
Mouse	мышь&amp;nbsp;[mysh']
Television	телевизор [televizor]
Dresser	комод [komod]
Steak knife	столовый нож [stolovyy nozh]
Politics	политика [politika]
Headphones	наушники [naushniki]
Boss (male)	начальник [nachal'nik]
Luggage check	проверка багажа [proverka bagazha]
Thirsty	жаждущий [zhazhdushchiy]
Bottle opener	открывала [otkryvalka]
Tip / gratuity	чаевые [chayeviye]
Relaxed	расслабленный [rasslablenniy]
Desk	письменный стол [pis'menniy stol]
Reservation	бронирование [bronirovaniye]
Boss (female)	начальница [nachal'nitsa]
Onion	лук [luk]
Lively	энергичный [energichniy]
Disagree	не соглашаться [ne soglashat'sya]
Mango	манго [mango] 
Sweet (noun) 	сладости [sladosti] 
Notebook	тетрадь [tetrad] 
The man is writing in the notebook	Человек пишет в тетради [Chelovek pishet v tetradi]
Eyelid	веко [veko]
Closed eyelids	закрытые веки [zakrytyye veki] 
I just have 5 minutes more to sleep	Посплю еще пять минут [posplyu yeshche pyat' minut] 
This is not my job	Это не в моих обязанностях [Eto ne v moikh obyazannostyakh] 
Gasoline	бензин [benzin] 
Mall	торговый центр [torgovyy tsentr] 
Telephone	телефон [telefon] 
Hold	держать [derzhat]
Necklace	ожерелье [ozherel'ye] 
Deer	олень [olen] 
Chair	стул [stul] 
Plate	посуда [posuda] 
Ladybug	божья коровка [bozh'ya korovka] 
Pig	свинья [svin'ya] 
Have a happy new year! 	Счастливого Нового года! [Schastlivogo Novogo goda!] 
Chicken	курица [kuritsa] 
Driver	водитель [voditel'] 
Drizzle	морось [moros']
Train	поезд [poyezd] 
Take the train	садиться на поезд [sadit'sya na poyezd] 
Dining room	столовая [stolovaya] 
Grass	трава [trava] 
January	январь [yanvar'] 
February	февраль [fevral'] 
March	март [mart] 
April	апрель [aprel'] 
May	май [may] 
June	июнь [iyun'] 
July	июль [iyul'] 
August	август [avgust] 
September	сентябрь [sentyabr'] 
October	октябрь [oktyabr'] 
November	ноябрь [noyabr'] 
December	декабрь [dekabr'] 
Plate	тарелка [tarelka] 
Satisfied	довольный [dovol'niy]
Clock	часы [chasy] 
Mushroom	гриб [grib] 
Younger brother	младший брат [mladshiy brat] 
Explain	объяснять [ob'yasnyat] 
That's true	Правда [pravda] 
Yes, you're right	Да, ты прав [da, tu prav] 
You're wrong	Вы не правы [vu ne pravu] 
Exactly 	Точно [tochno] 
Absolutely 	Абсолютно [Absalyutna] 
Maybe	Может быть [Mozhet but'] 
What do you think? 	Что вы думаете? [Chto vu dumaete?] 
I don't think so	Я так не думаю [Ya tak ne dumayu] 
I guess so	Полагаю, что так [Polagayu, chto tak] 
Wake up	просыпаться [prosypatsa] 
Time to wake up	пора просыпаться [pora prosypat'sya] 
The wife is hugging the husband	Жена обнимает мужа [Zhena obnimayet muzha] 
Text message	текстовое сообщение [tekstovoye soobshcheniye] 
Headache	головная боль        [golovnaya bol'] 
Tree	дерево [derevo] 
Pillow	подушка [podushka] 
Read	читать [chitat] 
Table	стол [stol] 
Channel	канал [kanal] 
Change the channel	переключить канал [pereklyuchit' kanal] 
Face	лицо [litso] 
Rhinoceros	носорог [nosorog] 
Lift up	поднимать [podnimat'] 
