A a	а [apple] 	
Б б	b [box] 	
В в	v [van] 	
Г г	g [get] 	
Д д	d [dog] 	
Е е	ye [yet] 	
Ё ё	yo [your] 	
Ж ж	s [pleasure] 	
З з	z [zoo] 	
И и	ee [feet] 	
Й й	y [boy] 	
К к	k [kit] 	
Л л	l [love] 	
М м	m [may] 	
Н н	n [not] 	
О о	o [top] 	
П п	p [pot] 	
Р р	r [rot with rolled r] 	
С с	s [set] 	
У у	oo [moon] 	
Ф ф	f [fit] 	
Х х	kh [loch] 	
Ц ц	ts [bits] 	
Ч ч	ch [choke] 	
Ш ш	sh [sharp] 	
Щ щ	shsh [pushchair with tongue lower] 	
Ъ	Hard sign (silent, prevents paletisation of preceding consonant) 	
Ы ы	y [physics] 	
Ь	Soft sign [silent, paletelises preceding consonant, sounds like adding a -y as in canyon to it] 	
Э э	e [met] 	
Ю ю	u [universe] 	
Я я	ya [yap] 	
Т т	t [to] 	